author: Ray Ling
version: 1.0
name: Lost Temple
size: 50x25
snake: 4
snakelength: 1
map:
.WWW.WW...........WWWW...WW..........X...WWWWWW..W
..X....W..W......W......XX...WW...................
W........WW.......W............W.............WWW..
.W......W........WW......S................WWW...WW
.W.......WW.......WW.....................W.......W
........W........W...........W..........W.......X.
..WWW.WW..........WWWW.......W........WW......S..X
.W.......WW.......WWW.W.....W........W............
W......................WW.WWWW..........W........W
....W...................WWW............W..........
.....WW................................WW.....WWW.
.W.....W..................W...................W..W
........W................W.W...............WW.....
W.......WW................W.......................
..........W.........W...............WW............
.X.......WWW.......W.WW...............W.WW........
W.S.........W.....WW...WW.W...............W...X...
.X.......WW......W.......W.WW............WW...WWW.
........W.......WW..........W.............WWWW...W
W......WW........WW.........WW..........WW........
.WW.WWW.........W.WW..........WWW.......W....X....
...W...............W..S.......W..........W........
.................WW....................WW.....WW..
..................WW....X...............W....W..W.
..................WWWW..x.WWWW.W.........W........
