name: Sample
author: Ray Ling
snakelength: 2
version: 1.0
snake: 2
size: 50x25
map:
..................................................
................................................S.
..WWWWWWWWWWWWWWWWWWWWWWWWWWWWWWWWWWWWWWWWWWWWWW..
..W............................................W..
..W..........................................X.W..
..W............................................W..
..W...WWWWWWWWWWWWWWWWWWWWWWWWWWWWWWWWWWWWWW...W..
..W...W....................................W...W..
..W...W....................................W...W..
..W...W....................................W...W..
..W...W....W...WWWWW...WWWWW...WWWWW.......W...W..
..W...W....W...W...W...W...W...W...W.......W...W..
......W....W.X.W.X.W.X.W.X.W.X.W.X.W...........W..
..W...W....W...W...W...W...W...W...W.......W...W..
..W...W....WWWWW...WWWWW...WWWWW...WWWW....W...W..
..W...W....................................W...W..
..W...W....................................W...W..
..W...W....................................W...W..
..W...WWWWWWWWWWWWWWWWWWWWWWWWWWWWWWWWWWWWWW...W..
..W............................................W..
..W..........................................X.W..
..W............................................W..
..WWWWWWWWWWWWWWWWWWWWWWWWWWWWWWWWWWWWWWWWWWWWWW..
................................................S.
..................................................
